Leapord/__Pounce.npz	Leapord/__Pounce.npz
Leapord/__Walk.npz	Leapord/__Walk.npz
Leapord/__DieLoop.npz	Leapord/__DieLoop.npz
Leapord/__Attack.npz	Leapord/__Attack.npz
Leapord/__TPOSE.npz	Leapord/__TPOSE.npz
Leapord/__Die.npz	Leapord/__Die.npz
Leapord/__Bite.npz	Leapord/__Bite.npz
Leapord/__Run.npz	Leapord/__Run.npz
Leapord/__Sick.npz	Leapord/__Sick.npz
Leapord/__Death.npz	Leapord/__Death.npz
Leapord/__PounceSwipe.npz	Leapord/__PounceSwipe.npz
Leapord/__Idle.npz	Leapord/__Idle.npz
Leapord/__Graze.npz	Leapord/__Graze.npz
Leapord/__Growl.npz	Leapord/__Growl.npz
Isopetra/__Attack3.npz	Isopetra/__Attack3.npz
Isopetra/__Idle3.npz	Isopetra/__Idle3.npz
Isopetra/__Walk.npz	Isopetra/__Walk.npz
Isopetra/__Attack2.npz	Isopetra/__Attack2.npz
Isopetra/__Attack.npz	Isopetra/__Attack.npz
Isopetra/__TPOSE.npz	Isopetra/__TPOSE.npz
Isopetra/__Die.npz	Isopetra/__Die.npz
Isopetra/__Run.npz	Isopetra/__Run.npz
Isopetra/__Idle2.npz	Isopetra/__Idle2.npz
Isopetra/__Idle.npz	Isopetra/__Idle.npz
Ant/__JumpForward.npz	Ant/__JumpForward.npz
Ant/__Idle3.npz	Ant/__Idle3.npz
Ant/__Walk.npz	Ant/__Walk.npz
Ant/__Cleaning.npz	Ant/__Cleaning.npz
Ant/__KnockedBack.npz	Ant/__KnockedBack.npz
Ant/__Throw.npz	Ant/__Throw.npz
Ant/__March.npz	Ant/__March.npz
Ant/__DieUp.npz	Ant/__DieUp.npz
Ant/__DieLoop.npz	Ant/__DieLoop.npz
Ant/__Attack.npz	Ant/__Attack.npz
Ant/__TPOSE.npz	Ant/__TPOSE.npz
Ant/__Die.npz	Ant/__Die.npz
Ant/__Die2.npz	Ant/__Die2.npz
Ant/__Sting.npz	Ant/__Sting.npz
Ant/__Idle2.npz	Ant/__Idle2.npz
Ant/__Shake.npz	Ant/__Shake.npz
Ant/__Idle.npz	Ant/__Idle.npz
Ant/__Sting2.npz	Ant/__Sting2.npz
Coyote/__Attack3.npz	Coyote/__Attack3.npz
Coyote/__Restless.npz	Coyote/__Restless.npz
Coyote/__Sniffing.npz	Coyote/__Sniffing.npz
Coyote/__Walking.npz	Coyote/__Walking.npz
Coyote/__Attack2.npz	Coyote/__Attack2.npz
Coyote/__TPOSE.npz	Coyote/__TPOSE.npz
Coyote/__Howling.npz	Coyote/__Howling.npz
Coyote/__Die.npz	Coyote/__Die.npz
Coyote/__Running.npz	Coyote/__Running.npz
Coyote/__Attack1.npz	Coyote/__Attack1.npz
Coyote/__Idle.npz	Coyote/__Idle.npz
Deer/__GetUpAgain.npz	Deer/__GetUpAgain.npz
Deer/__Squirly.npz	Deer/__Squirly.npz
Deer/__TakeOff.npz	Deer/__TakeOff.npz
Deer/__TurnLeft.npz	Deer/__TurnLeft.npz
Deer/__BuckShy.npz	Deer/__BuckShy.npz
Deer/__ComeDown.npz	Deer/__ComeDown.npz
Deer/__WalkForward.npz	Deer/__WalkForward.npz
Deer/__Charge.npz	Deer/__Charge.npz
Deer/__Backing.npz	Deer/__Backing.npz
Deer/__Trot.npz	Deer/__Trot.npz
Deer/__Bleat.npz	Deer/__Bleat.npz
Deer/__TPOSE.npz	Deer/__TPOSE.npz
Deer/__WalkBack.npz	Deer/__WalkBack.npz
Deer/__Rutting.npz	Deer/__Rutting.npz
Deer/__GetUp.npz	Deer/__GetUp.npz
Deer/__Gallop.npz	Deer/__Gallop.npz
Deer/__Idle.npz	Deer/__Idle.npz
Deer/__idleEarFlik.npz	Deer/__idleEarFlik.npz
Deer/__Grazing.npz	Deer/__Grazing.npz
Deer/__WalkCall.npz	Deer/__WalkCall.npz
Deer/__RearUp.npz	Deer/__RearUp.npz
Hamster/__Walk.npz	Hamster/__Walk.npz
Hamster/__Sniff.npz	Hamster/__Sniff.npz
Hamster/__TPOSE.npz	Hamster/__TPOSE.npz
Hamster/__Run.npz	Hamster/__Run.npz
Hamster/__RollAttack.npz	Hamster/__RollAttack.npz
Hamster/__Idle.npz	Hamster/__Idle.npz
Mammoth/__DeathLoop.npz	Mammoth/__DeathLoop.npz
Mammoth/__Bellow.npz	Mammoth/__Bellow.npz
Mammoth/__Walk.npz	Mammoth/__Walk.npz
Mammoth/__SideSwipe.npz	Mammoth/__SideSwipe.npz
Mammoth/__Gesture.npz	Mammoth/__Gesture.npz
Mammoth/__TPOSE.npz	Mammoth/__TPOSE.npz
Mammoth/__Die.npz	Mammoth/__Die.npz
Mammoth/__Run.npz	Mammoth/__Run.npz
Mammoth/__Die2.npz	Mammoth/__Die2.npz
Mammoth/__GetUp.npz	Mammoth/__GetUp.npz
Mammoth/__Idle2.npz	Mammoth/__Idle2.npz
Mammoth/__IDLE.npz	Mammoth/__IDLE.npz
Mammoth/__Rise.npz	Mammoth/__Rise.npz
Jaguar/__LieIdle.npz	Jaguar/__LieIdle.npz
Jaguar/__Die1.npz	Jaguar/__Die1.npz
Jaguar/__Walk.npz	Jaguar/__Walk.npz
Jaguar/__Attack2.npz	Jaguar/__Attack2.npz
Jaguar/__Sit.npz	Jaguar/__Sit.npz
Jaguar/__Attack.npz	Jaguar/__Attack.npz
Jaguar/__TPOSE.npz	Jaguar/__TPOSE.npz
Jaguar/__Run.npz	Jaguar/__Run.npz
Jaguar/__Die2.npz	Jaguar/__Die2.npz
Jaguar/__Attack1.npz	Jaguar/__Attack1.npz
Jaguar/__GetUp.npz	Jaguar/__GetUp.npz
Jaguar/__Low.npz	Jaguar/__Low.npz
Jaguar/__Stancing.npz	Jaguar/__Stancing.npz
Jaguar/__Idle.npz	Jaguar/__Idle.npz
Lynx/__Attack3.npz	Lynx/__Attack3.npz
Lynx/__Idle3.npz	Lynx/__Idle3.npz
Lynx/__Walk.npz	Lynx/__Walk.npz
Lynx/__Stand.npz	Lynx/__Stand.npz
Lynx/__Attack2.npz	Lynx/__Attack2.npz
Lynx/__Idle4.npz	Lynx/__Idle4.npz
Lynx/__DieLoop.npz	Lynx/__DieLoop.npz
Lynx/__Attack.npz	Lynx/__Attack.npz
Lynx/__TPOSE.npz	Lynx/__TPOSE.npz
Lynx/__Die.npz	Lynx/__Die.npz
Lynx/__Run.npz	Lynx/__Run.npz
Lynx/__Die2.npz	Lynx/__Die2.npz
Lynx/__Idle2.npz	Lynx/__Idle2.npz
Lynx/__Idle.npz	Lynx/__Idle.npz
Lynx/__Jump.npz	Lynx/__Jump.npz
Spider/__SlowIdle.npz	Spider/__SlowIdle.npz
Spider/__TravelWeb.npz	Spider/__TravelWeb.npz
Spider/__Rearing.npz	Spider/__Rearing.npz
Spider/__runleft.npz	Spider/__runleft.npz
Spider/__Attack5.npz	Spider/__Attack5.npz
Spider/__Scramble.npz	Spider/__Scramble.npz
Spider/__weaving.npz	Spider/__weaving.npz
Spider/__Fangy.npz	Spider/__Fangy.npz
Spider/__Hurt.npz	Spider/__Hurt.npz
Spider/__BackRear.npz	Spider/__BackRear.npz
Spider/__barking.npz	Spider/__barking.npz
Spider/__Riser.npz	Spider/__Riser.npz
Spider/__Attack2.npz	Spider/__Attack2.npz
Spider/__Retreat.npz	Spider/__Retreat.npz
Spider/__Walker.npz	Spider/__Walker.npz
Spider/__Attackright.npz	Spider/__Attackright.npz
Spider/__Landing.npz	Spider/__Landing.npz
Spider/__Scary.npz	Spider/__Scary.npz
Spider/__walkleft.npz	Spider/__walkleft.npz
Spider/__Attack4.npz	Spider/__Attack4.npz
Spider/__Rising.npz	Spider/__Rising.npz
Spider/__TPOSE.npz	Spider/__TPOSE.npz
Spider/__BackitUp.npz	Spider/__BackitUp.npz
Spider/__Attack1.npz	Spider/__Attack1.npz
Spider/__walkloop.npz	Spider/__walkloop.npz
Spider/__injuredwalk.npz	Spider/__injuredwalk.npz
Spider/__weaver.npz	Spider/__weaver.npz
Spider/__RetreatInjured.npz	Spider/__RetreatInjured.npz
Spider/__Gliding.npz	Spider/__Gliding.npz
Spider/__LandinHAir.npz	Spider/__LandinHAir.npz
Spider/__RetreatSlow.npz	Spider/__RetreatSlow.npz
Spider/__Jump.npz	Spider/__Jump.npz
Spider/__AttackLeft.npz	Spider/__AttackLeft.npz
Roach/__Uppity.npz	Roach/__Uppity.npz
Roach/__Smelling.npz	Roach/__Smelling.npz
Roach/__TurnLeft.npz	Roach/__TurnLeft.npz
Roach/__Left.npz	Roach/__Left.npz
Roach/__Move.npz	Roach/__Move.npz
Roach/__TurnRight.npz	Roach/__TurnRight.npz
Roach/__TPOSE.npz	Roach/__TPOSE.npz
Roach/__Scurry.npz	Roach/__Scurry.npz
Roach/__Shake.npz	Roach/__Shake.npz
Roach/__Hop.npz	Roach/__Hop.npz
Roach/__Bristle.npz	Roach/__Bristle.npz
Roach/__Fall.npz	Roach/__Fall.npz
Tricera/__Attack3.npz	Tricera/__Attack3.npz
Tricera/__Walk.npz	Tricera/__Walk.npz
Tricera/__Attack2.npz	Tricera/__Attack2.npz
Tricera/__Attack4.npz	Tricera/__Attack4.npz
Tricera/__Attack.npz	Tricera/__Attack.npz
Tricera/__TPOSE.npz	Tricera/__TPOSE.npz
Tricera/__Run.npz	Tricera/__Run.npz
Tricera/__NoseDirt.npz	Tricera/__NoseDirt.npz
Tricera/__Idle.npz	Tricera/__Idle.npz
Tricera/__Fall.npz	Tricera/__Fall.npz
Scorpion/__BackUp.npz	Scorpion/__BackUp.npz
Scorpion/__Agitated.npz	Scorpion/__Agitated.npz
Scorpion/__TurnLeft.npz	Scorpion/__TurnLeft.npz
Scorpion/__WalkForward.npz	Scorpion/__WalkForward.npz
Scorpion/__Recoil.npz	Scorpion/__Recoil.npz
Scorpion/__TurnRight.npz	Scorpion/__TurnRight.npz
Scorpion/__TPOSE.npz	Scorpion/__TPOSE.npz
Scorpion/__Stinger.npz	Scorpion/__Stinger.npz
Scorpion/__Attack1.npz	Scorpion/__Attack1.npz
Scorpion/__IdleLoop.npz	Scorpion/__IdleLoop.npz
Scorpion/__Defend.npz	Scorpion/__Defend.npz
Scorpion/__StretchArms.npz	Scorpion/__StretchArms.npz
Scorpion/__Recoil2.npz	Scorpion/__Recoil2.npz
Scorpion/__SlowForward.npz	Scorpion/__SlowForward.npz
Tyranno/__HeadButt.npz	Tyranno/__HeadButt.npz
Tyranno/__Walk.npz	Tyranno/__Walk.npz
Tyranno/__Attack2.npz	Tyranno/__Attack2.npz
Tyranno/__TailWhip.npz	Tyranno/__TailWhip.npz
Tyranno/__Attack.npz	Tyranno/__Attack.npz
Tyranno/__TPOSE.npz	Tyranno/__TPOSE.npz
Tyranno/__Run.npz	Tyranno/__Run.npz
Tyranno/__Roar.npz	Tyranno/__Roar.npz
Tyranno/__Idle2.npz	Tyranno/__Idle2.npz
Tyranno/__Idle.npz	Tyranno/__Idle.npz
Tyranno/__Fall.npz	Tyranno/__Fall.npz
Pigeon/__Land.npz	Pigeon/__Land.npz
Pigeon/__TakeOff.npz	Pigeon/__TakeOff.npz
Pigeon/__FlyLoop.npz	Pigeon/__FlyLoop.npz
Pigeon/__Walk.npz	Pigeon/__Walk.npz
Pigeon/__Circle.npz	Pigeon/__Circle.npz
Pigeon/__Left.npz	Pigeon/__Left.npz
Pigeon/__Cooing.npz	Pigeon/__Cooing.npz
Pigeon/__TPOSE.npz	Pigeon/__TPOSE.npz
Pigeon/__IdleLoop.npz	Pigeon/__IdleLoop.npz
Pigeon/__Idle.npz	Pigeon/__Idle.npz
Pigeon/__Peck.npz	Pigeon/__Peck.npz
Pigeon/__Right.npz	Pigeon/__Right.npz
FireAnt/__BackUp.npz	FireAnt/__BackUp.npz
FireAnt/__Creep.npz	FireAnt/__Creep.npz
FireAnt/__Annoyed.npz	FireAnt/__Annoyed.npz
FireAnt/__TurnLeft.npz	FireAnt/__TurnLeft.npz
FireAnt/__Rip.npz	FireAnt/__Rip.npz
FireAnt/__Left.npz	FireAnt/__Left.npz
FireAnt/__Snap.npz	FireAnt/__Snap.npz
FireAnt/__Gesture.npz	FireAnt/__Gesture.npz
FireAnt/__Angry.npz	FireAnt/__Angry.npz
FireAnt/__TurnRight.npz	FireAnt/__TurnRight.npz
FireAnt/__TPOSE.npz	FireAnt/__TPOSE.npz
FireAnt/__UpFromDown.npz	FireAnt/__UpFromDown.npz
FireAnt/__Bite.npz	FireAnt/__Bite.npz
FireAnt/__Hungry.npz	FireAnt/__Hungry.npz
FireAnt/__Roar.npz	FireAnt/__Roar.npz
FireAnt/__FightOff.npz	FireAnt/__FightOff.npz
FireAnt/__RipFlesh2.npz	FireAnt/__RipFlesh2.npz
FireAnt/__Idle.npz	FireAnt/__Idle.npz
FireAnt/__RipFlesh.npz	FireAnt/__RipFlesh.npz
FireAnt/__Hit.npz	FireAnt/__Hit.npz
FireAnt/__ForwardMarch.npz	FireAnt/__ForwardMarch.npz
FireAnt/__Right.npz	FireAnt/__Right.npz
FireAnt/__UpFromDown2.npz	FireAnt/__UpFromDown2.npz
FireAnt/__Jump.npz	FireAnt/__Jump.npz
FireAnt/__Feel.npz	FireAnt/__Feel.npz
Crab/__Eat.npz	Crab/__Eat.npz
Crab/__Attack3.npz	Crab/__Attack3.npz
Crab/__Walk.npz	Crab/__Walk.npz
Crab/__Attack2.npz	Crab/__Attack2.npz
Crab/__Attack4.npz	Crab/__Attack4.npz
Crab/__TPOSE.npz	Crab/__TPOSE.npz
Crab/__Die.npz	Crab/__Die.npz
Crab/__Attack1.npz	Crab/__Attack1.npz
Crab/__HitBack.npz	Crab/__HitBack.npz
Crab/__Strafe.npz	Crab/__Strafe.npz
Crab/__Defeated.npz	Crab/__Defeated.npz
Elephant/__idle2.npz	Elephant/__idle2.npz
Elephant/__Idle3.npz	Elephant/__Idle3.npz
Elephant/__Firing.npz	Elephant/__Firing.npz
Elephant/__Attack2.npz	Elephant/__Attack2.npz
Elephant/__Take_001.npz	Elephant/__Take_001.npz
Elephant/__DownIn.npz	Elephant/__DownIn.npz
Elephant/__TPOSE.npz	Elephant/__TPOSE.npz
Elephant/__Die.npz	Elephant/__Die.npz
Elephant/__Run.npz	Elephant/__Run.npz
Elephant/__Attack1.npz	Elephant/__Attack1.npz
Elephant/__DownOut.npz	Elephant/__DownOut.npz
Elephant/__walk.npz	Elephant/__walk.npz
Elephant/__Idle1.npz	Elephant/__Idle1.npz
Elephant/__DownLoop.npz	Elephant/__DownLoop.npz
Elephant/__Passout.npz	Elephant/__Passout.npz
Bear/__TipLeft.npz	Bear/__TipLeft.npz
Bear/__LayDown.npz	Bear/__LayDown.npz
Bear/__RunningBear.npz	Bear/__RunningBear.npz
Bear/__SlowWalk.npz	Bear/__SlowWalk.npz
Bear/__Stalking.npz	Bear/__Stalking.npz
Bear/__BackUp.npz	Bear/__BackUp.npz
Bear/__CatchFish.npz	Bear/__CatchFish.npz
Bear/__JumpBite.npz	Bear/__JumpBite.npz
Bear/__TurnLeft.npz	Bear/__TurnLeft.npz
Bear/__Feast.npz	Bear/__Feast.npz
Bear/__Stand.npz	Bear/__Stand.npz
Bear/__SwatRight.npz	Bear/__SwatRight.npz
Bear/__WakeUp.npz	Bear/__WakeUp.npz
Bear/__WetShake.npz	Bear/__WetShake.npz
Bear/__AngerySwat.npz	Bear/__AngerySwat.npz
Bear/__WalkForward.npz	Bear/__WalkForward.npz
Bear/__Turn180.npz	Bear/__Turn180.npz
Bear/__SwatLeft.npz	Bear/__SwatLeft.npz
Bear/__Trot.npz	Bear/__Trot.npz
Bear/__TPOSE.npz	Bear/__TPOSE.npz
Bear/__Bite.npz	Bear/__Bite.npz
Bear/__GroundPaw.npz	Bear/__GroundPaw.npz
Bear/__GetUp.npz	Bear/__GetUp.npz
Bear/__RiseRoar.npz	Bear/__RiseRoar.npz
Bear/__Idle.npz	Bear/__Idle.npz
Bear/__Trotting.npz	Bear/__Trotting.npz
Bear/__BearRun.npz	Bear/__BearRun.npz
Bear/__FishBite.npz	Bear/__FishBite.npz
Bear/__Growl.npz	Bear/__Growl.npz
Bear/__IdlePant.npz	Bear/__IdlePant.npz
SpiderG/__Attack5.npz	SpiderG/__Attack5.npz
SpiderG/__Attack3.npz	SpiderG/__Attack3.npz
SpiderG/__Idle3.npz	SpiderG/__Idle3.npz
SpiderG/__Fangs.npz	SpiderG/__Fangs.npz
SpiderG/__Walk.npz	SpiderG/__Walk.npz
SpiderG/__Attack2.npz	SpiderG/__Attack2.npz
SpiderG/__Retreat.npz	SpiderG/__Retreat.npz
SpiderG/__Attack4.npz	SpiderG/__Attack4.npz
SpiderG/__Attack.npz	SpiderG/__Attack.npz
SpiderG/__ComeOut.npz	SpiderG/__ComeOut.npz
SpiderG/__TPOSE.npz	SpiderG/__TPOSE.npz
SpiderG/__Die.npz	SpiderG/__Die.npz
SpiderG/__Run.npz	SpiderG/__Run.npz
SpiderG/__Attack6.npz	SpiderG/__Attack6.npz
SpiderG/__Idle2.npz	SpiderG/__Idle2.npz
SpiderG/__Idle.npz	SpiderG/__Idle.npz
SpiderG/__Shiver.npz	SpiderG/__Shiver.npz
SpiderG/__Attack7.npz	SpiderG/__Attack7.npz
SpiderG/__Burrough.npz	SpiderG/__Burrough.npz
Gazelle/__Alert.npz	Gazelle/__Alert.npz
Gazelle/__IdleReady.npz	Gazelle/__IdleReady.npz
Gazelle/__HeadPoke.npz	Gazelle/__HeadPoke.npz
Gazelle/__Walk.npz	Gazelle/__Walk.npz
Gazelle/__Attack.npz	Gazelle/__Attack.npz
Gazelle/__TPOSE.npz	Gazelle/__TPOSE.npz
Gazelle/__Run.npz	Gazelle/__Run.npz
Gazelle/__Attack1.npz	Gazelle/__Attack1.npz
Gazelle/__Idle.npz	Gazelle/__Idle.npz
Gazelle/__Fall.npz	Gazelle/__Fall.npz
Rhino/__Attack3.npz	Rhino/__Attack3.npz
Rhino/__Idle3.npz	Rhino/__Idle3.npz
Rhino/__Walk.npz	Rhino/__Walk.npz
Rhino/__Attack2.npz	Rhino/__Attack2.npz
Rhino/__idle.npz	Rhino/__idle.npz
Rhino/__Attack.npz	Rhino/__Attack.npz
Rhino/__TPOSE.npz	Rhino/__TPOSE.npz
Rhino/__Die.npz	Rhino/__Die.npz
Rhino/__Run.npz	Rhino/__Run.npz
Rhino/__Idle2.npz	Rhino/__Idle2.npz
Crow/__Landflap.npz	Crow/__Landflap.npz
Crow/__TakeOff.npz	Crow/__TakeOff.npz
Crow/__Attack2.npz	Crow/__Attack2.npz
Crow/__FlyStart.npz	Crow/__FlyStart.npz
Crow/__Attack.npz	Crow/__Attack.npz
Crow/__Glide.npz	Crow/__Glide.npz
Crow/__TPOSE.npz	Crow/__TPOSE.npz
Crow/__Idle.npz	Crow/__Idle.npz
Crow/__Ascend.npz	Crow/__Ascend.npz
Crow/__IdleFlap.npz	Crow/__IdleFlap.npz
Crow/__PeckEat.npz	Crow/__PeckEat.npz
Bat/__SlowFly.npz	Bat/__SlowFly.npz
Bat/__Kick.npz	Bat/__Kick.npz
Bat/__Float.npz	Bat/__Float.npz
Bat/__AttackBite.npz	Bat/__AttackBite.npz
Bat/__Looking.npz	Bat/__Looking.npz
Bat/__FlyLoop.npz	Bat/__FlyLoop.npz
Bat/__Walk.npz	Bat/__Walk.npz
Bat/__Fly.npz	Bat/__Fly.npz
Bat/__KnockedBack.npz	Bat/__KnockedBack.npz
Bat/__TPOSE.npz	Bat/__TPOSE.npz
Bat/__FlyGlide.npz	Bat/__FlyGlide.npz
Horse/__SlowIdle.npz	Horse/__SlowIdle.npz
Horse/__Rearing.npz	Horse/__Rearing.npz
Horse/__LandRun.npz	Horse/__LandRun.npz
Horse/__SlowWalk.npz	Horse/__SlowWalk.npz
Horse/__BackUp.npz	Horse/__BackUp.npz
Horse/__Dying.npz	Horse/__Dying.npz
Horse/__Idle3.npz	Horse/__Idle3.npz
Horse/__RunLoop.npz	Horse/__RunLoop.npz
Horse/__Restless.npz	Horse/__Restless.npz
Horse/__RunToStop.npz	Horse/__RunToStop.npz
Horse/__HoofScrape2.npz	Horse/__HoofScrape2.npz
Horse/__HoofScrape.npz	Horse/__HoofScrape.npz
Horse/__Rearing2.npz	Horse/__Rearing2.npz
Horse/__KnockedBack.npz	Horse/__KnockedBack.npz
Horse/__FeetUp.npz	Horse/__FeetUp.npz
Horse/__Bucking.npz	Horse/__Bucking.npz
Horse/__IdleEars.npz	Horse/__IdleEars.npz
Horse/__JumpLand.npz	Horse/__JumpLand.npz
Horse/__Attack.npz	Horse/__Attack.npz
Horse/__LoneRanger.npz	Horse/__LoneRanger.npz
Horse/__TPOSE.npz	Horse/__TPOSE.npz
Horse/__GetUp.npz	Horse/__GetUp.npz
Horse/__RunJump.npz	Horse/__RunJump.npz
Horse/__Lying.npz	Horse/__Lying.npz
Horse/__Idle.npz	Horse/__Idle.npz
Horse/__Jumping.npz	Horse/__Jumping.npz
Horse/__Restless3.npz	Horse/__Restless3.npz
Horse/__InAir.npz	Horse/__InAir.npz
Horse/__Restless2.npz	Horse/__Restless2.npz
Comodoa/__Attack3.npz	Comodoa/__Attack3.npz
Comodoa/__Walk.npz	Comodoa/__Walk.npz
Comodoa/__Attack2.npz	Comodoa/__Attack2.npz
Comodoa/__TPOSE.npz	Comodoa/__TPOSE.npz
Comodoa/__Die.npz	Comodoa/__Die.npz
Comodoa/__Run.npz	Comodoa/__Run.npz
Comodoa/__Attack1.npz	Comodoa/__Attack1.npz
Comodoa/__Idle2.npz	Comodoa/__Idle2.npz
Comodoa/__Idle.npz	Comodoa/__Idle.npz
Comodoa/__Yawn.npz	Comodoa/__Yawn.npz
Parrot/__Die3.npz	Parrot/__Die3.npz
Parrot/__Land.npz	Parrot/__Land.npz
Parrot/__Walk.npz	Parrot/__Walk.npz
Parrot/__Fly.npz	Parrot/__Fly.npz
Parrot/__Attack.npz	Parrot/__Attack.npz
Parrot/__TPOSE.npz	Parrot/__TPOSE.npz
Parrot/__Die.npz	Parrot/__Die.npz
Parrot/__Die2.npz	Parrot/__Die2.npz
Parrot/__Idle2.npz	Parrot/__Idle2.npz
Parrot/__CircleFly.npz	Parrot/__CircleFly.npz
Parrot/__Rise.npz	Parrot/__Rise.npz
Parrot/__Idle.npz	Parrot/__Idle.npz
Parrot/__Hover.npz	Parrot/__Hover.npz
Parrot/__Preen.npz	Parrot/__Preen.npz
Turtle/__Onback.npz	Turtle/__Onback.npz
Turtle/__Attack3.npz	Turtle/__Attack3.npz
Turtle/__Walk.npz	Turtle/__Walk.npz
Turtle/__Attack2.npz	Turtle/__Attack2.npz
Turtle/__Attack.npz	Turtle/__Attack.npz
Turtle/__TPOSE.npz	Turtle/__TPOSE.npz
Turtle/__Run.npz	Turtle/__Run.npz
Turtle/__Idle2.npz	Turtle/__Idle2.npz
Turtle/__Idle.npz	Turtle/__Idle.npz
Turtle/__Yawn.npz	Turtle/__Yawn.npz
Turtle/__Hide.npz	Turtle/__Hide.npz
PolarBearB/__Walk.npz	PolarBearB/__Walk.npz
PolarBearB/__Play.npz	PolarBearB/__Play.npz
PolarBearB/__TPOSE.npz	PolarBearB/__TPOSE.npz
PolarBearB/__Run.npz	PolarBearB/__Run.npz
PolarBearB/__GetUp.npz	PolarBearB/__GetUp.npz
PolarBearB/__Idle2.npz	PolarBearB/__Idle2.npz
PolarBearB/__Idle.npz	PolarBearB/__Idle.npz
PolarBearB/__Fall.npz	PolarBearB/__Fall.npz
Raptor3/__Yell.npz	Raptor3/__Yell.npz
Raptor3/__StepRoar.npz	Raptor3/__StepRoar.npz
Raptor3/__StepLeft.npz	Raptor3/__StepLeft.npz
Raptor3/__StepRight.npz	Raptor3/__StepRight.npz
Raptor3/__MeanLEft.npz	Raptor3/__MeanLEft.npz
Raptor3/__RoarLeft.npz	Raptor3/__RoarLeft.npz
Raptor3/__roarforward.npz	Raptor3/__roarforward.npz
Raptor3/__TPOSE.npz	Raptor3/__TPOSE.npz
Raptor3/__RoarRight.npz	Raptor3/__RoarRight.npz
Raptor3/__LeftPuke.npz	Raptor3/__LeftPuke.npz
Raptor3/__run.npz	Raptor3/__run.npz
Raptor3/__MeanRight.npz	Raptor3/__MeanRight.npz
Raptor3/__AttackRight.npz	Raptor3/__AttackRight.npz
Raptor3/__BarkForward.npz	Raptor3/__BarkForward.npz
Raptor/__SlowWalk.npz	Raptor/__SlowWalk.npz
Raptor/__LegScratch.npz	Raptor/__LegScratch.npz
Raptor/__Attack.npz	Raptor/__Attack.npz
Raptor/__TPOSE.npz	Raptor/__TPOSE.npz
Raptor/__Die.npz	Raptor/__Die.npz
Raptor/__HeadSmash.npz	Raptor/__HeadSmash.npz
Raptor/__Roar.npz	Raptor/__Roar.npz
Raptor/__Idle2.npz	Raptor/__Idle2.npz
Raptor/__FastWalk.npz	Raptor/__FastWalk.npz
Raptor/__Idle.npz	Raptor/__Idle.npz
Raptor/__Yawn.npz	Raptor/__Yawn.npz
HermitCrab/__Eat.npz	HermitCrab/__Eat.npz
HermitCrab/__Slowwalk.npz	HermitCrab/__Slowwalk.npz
HermitCrab/__Walk.npz	HermitCrab/__Walk.npz
HermitCrab/__Pinchers.npz	HermitCrab/__Pinchers.npz
HermitCrab/__KnockedBack.npz	HermitCrab/__KnockedBack.npz
HermitCrab/__OutofGround.npz	HermitCrab/__OutofGround.npz
HermitCrab/__Take_001.npz	HermitCrab/__Take_001.npz
HermitCrab/__KnockedOut.npz	HermitCrab/__KnockedOut.npz
HermitCrab/__TPOSE.npz	HermitCrab/__TPOSE.npz
HermitCrab/__Die.npz	HermitCrab/__Die.npz
HermitCrab/__Sleep.npz	HermitCrab/__Sleep.npz
HermitCrab/__SandBurrough.npz	HermitCrab/__SandBurrough.npz
HermitCrab/__Expire.npz	HermitCrab/__Expire.npz
HermitCrab/__Fighting.npz	HermitCrab/__Fighting.npz
SandMouse/__Die3.npz	SandMouse/__Die3.npz
SandMouse/__Idle3.npz	SandMouse/__Idle3.npz
SandMouse/__Walk.npz	SandMouse/__Walk.npz
SandMouse/__DigIn.npz	SandMouse/__DigIn.npz
SandMouse/__Attack2.npz	SandMouse/__Attack2.npz
SandMouse/__Idle4.npz	SandMouse/__Idle4.npz
SandMouse/__DigOut.npz	SandMouse/__DigOut.npz
SandMouse/__Attack.npz	SandMouse/__Attack.npz
SandMouse/__TPOSE.npz	SandMouse/__TPOSE.npz
SandMouse/__Die.npz	SandMouse/__Die.npz
SandMouse/__Run.npz	SandMouse/__Run.npz
SandMouse/__Die2.npz	SandMouse/__Die2.npz
SandMouse/__Idle2.npz	SandMouse/__Idle2.npz
SandMouse/__Idle.npz	SandMouse/__Idle.npz
PolarBear/__Attack3.npz	PolarBear/__Attack3.npz
PolarBear/__Idle3.npz	PolarBear/__Idle3.npz
PolarBear/__Walk.npz	PolarBear/__Walk.npz
PolarBear/__Attack2.npz	PolarBear/__Attack2.npz
PolarBear/__Attack.npz	PolarBear/__Attack.npz
PolarBear/__TPOSE.npz	PolarBear/__TPOSE.npz
PolarBear/__Die.npz	PolarBear/__Die.npz
PolarBear/__Run.npz	PolarBear/__Run.npz
PolarBear/__Idle2.npz	PolarBear/__Idle2.npz
PolarBear/__Idle.npz	PolarBear/__Idle.npz
Hippopotamus/__Attack3.npz	Hippopotamus/__Attack3.npz
Hippopotamus/__Walk.npz	Hippopotamus/__Walk.npz
Hippopotamus/__Attack2.npz	Hippopotamus/__Attack2.npz
Hippopotamus/__Attack4.npz	Hippopotamus/__Attack4.npz
Hippopotamus/__Attack.npz	Hippopotamus/__Attack.npz
Hippopotamus/__TPOSE.npz	Hippopotamus/__TPOSE.npz
Hippopotamus/__Die.npz	Hippopotamus/__Die.npz
Hippopotamus/__Run.npz	Hippopotamus/__Run.npz
Hippopotamus/__Idle2.npz	Hippopotamus/__Idle2.npz
Hippopotamus/__Idle.npz	Hippopotamus/__Idle.npz
Hippopotamus/__Yawn.npz	Hippopotamus/__Yawn.npz
Buffalo/__SleepUp.npz	Buffalo/__SleepUp.npz
Buffalo/__RunLoop.npz	Buffalo/__RunLoop.npz
Buffalo/__Cud.npz	Buffalo/__Cud.npz
Buffalo/__HoofScrape.npz	Buffalo/__HoofScrape.npz
Buffalo/__GroundLoop.npz	Buffalo/__GroundLoop.npz
Buffalo/__Attack.npz	Buffalo/__Attack.npz
Buffalo/__TPOSE.npz	Buffalo/__TPOSE.npz
Buffalo/__Die.npz	Buffalo/__Die.npz
Buffalo/__LoweredHead.npz	Buffalo/__LoweredHead.npz
Buffalo/__Attack1.npz	Buffalo/__Attack1.npz
Buffalo/__GetUp.npz	Buffalo/__GetUp.npz
Buffalo/__Idle.npz	Buffalo/__Idle.npz
Buffalo/__ChargedUp.npz	Buffalo/__ChargedUp.npz
Buffalo/__AlertIdle.npz	Buffalo/__AlertIdle.npz
Buffalo/__AngryAntlers.npz	Buffalo/__AngryAntlers.npz
Buffalo/__Shot.npz	Buffalo/__Shot.npz
Buffalo/__Jump.npz	Buffalo/__Jump.npz
Buffalo/__WalkLoop.npz	Buffalo/__WalkLoop.npz
Buffalo/__Fall.npz	Buffalo/__Fall.npz
